4 5 4 5 4 4 4 4 4 4 5 5 4 4 4 5 4 5 4 4 5 4 4 4 5 4 4 4 4 4 4 4 
5 4 5 4 4 3 0 0 12 1 0 1 0 0 4 4 5 5 4 12 2 8 12 2 2 2 12 0 12 0 5 4 
4 4 4 4 4 0 4 4 4 4 5 4 4 12 4 4 4 4 4 2 4 0 4 4 4 4 5 4 4 3 4 5 
4 4 4 5 4 0 4 4 4 4 4 4 4 1 4 0 12 12 12 0 4 3 2 3 12 0 3 0 4 3 5 4 
4 5 4 4 4 12 4 4 4 5 5 5 4 12 5 12 5 4 4 4 5 4 5 4 4 5 4 12 5 0 4 4 
4 5 4 4 4 12 4 4 4 4 5 4 5 12 3 8 4 12 0 12 0 12 12 12 6 3 8 0 4 12 5 5 
4 4 4 5 4 7 4 4 4 4 5 4 4 2 4 4 4 12 12 0 1 1 3 12 5 3 5 4 4 12 5 4 
4 4 4 4 4 8 0 12 0 0 12 12 4 1 8 0 4 12 1 0 1 12 0 0 4 12 12 8 4 12 4 5 
4 4 4 4 4 12 0 2 12 0 0 2 5 4 4 12 4 4 5 5 4 4 6 4 4 5 5 12 4 0 5 5 
5 5 5 4 5 12 12 12 0 8 12 12 4 4 4 12 4 5 5 12 2 0 2 12 0 2 12 8 4 2 5 4 
5 4 4 0 7 1 12 0 3 0 0 0 7 3 5 1 4 5 4 1 4 4 5 5 4 4 4 4 5 1 5 4 
4 1 0 0 4 8 0 0 0 0 0 12 5 0 8 12 5 5 4 1 4 8 8 12 12 0 1 0 4 0 4 5 
4 0 4 4 5 12 0 1 0 2 12 1 4 4 5 5 4 5 4 0 4 7 5 5 5 4 4 1 4 12 5 4 
5 0 5 5 4 3 12 12 0 8 0 0 4 5 5 5 4 5 4 12 4 12 0 0 0 3 5 12 4 12 4 4 
4 12 5 4 4 4 4 7 4 4 4 5 4 4 4 4 4 4 5 1 4 1 1 0 12 0 4 12 5 12 4 4 
5 0 4 12 0 12 4 0 0 12 4 5 5 4 4 4 4 4 4 12 4 3 12 0 12 12 4 0 4 12 5 4 
4 0 4 1 4 12 5 1 4 0 5 5 5 4 5 4 4 4 4 1 4 0 2 3 0 12 5 12 4 2 4 4 
4 12 4 0 4 12 4 0 5 12 4 1 0 8 12 0 12 12 4 12 4 0 3 0 12 12 5 12 0 12 4 4 
4 0 5 12 4 0 4 0 4 8 4 3 1 8 1 12 0 12 4 1 6 1 0 12 2 0 4 3 5 4 5 4 
5 0 5 12 4 12 12 3 4 1 4 0 8 1 0 2 1 1 4 2 4 12 2 12 8 12 4 12 4 4 4 5 
5 12 5 0 5 4 6 4 5 12 5 0 12 12 12 1 8 12 5 0 4 7 5 4 4 4 4 12 4 4 4 5 
5 12 4 3 4 1 2 3 7 0 4 0 8 12 12 1 3 3 6 12 2 2 4 4 4 4 4 12 12 2 4 4 
5 0 5 0 4 2 2 12 4 12 7 3 12 12 12 12 0 0 5 0 4 3 4 4 4 5 4 6 4 12 5 4 
4 2 3 12 4 3 1 12 4 2 4 0 12 0 1 12 12 3 7 12 5 0 4 8 12 12 2 2 4 1 5 5 
4 4 4 4 4 4 5 5 4 0 4 4 4 7 4 4 5 4 4 4 4 0 4 3 0 0 0 12 4 0 4 4 
4 4 5 12 8 0 0 12 4 2 12 12 4 0 1 12 3 12 5 12 12 1 5 2 0 12 3 3 4 0 4 5 
4 4 5 12 5 4 4 0 5 5 5 0 4 1 4 4 4 1 4 12 5 4 4 0 12 0 0 0 6 0 4 5 
4 0 2 12 5 4 5 1 0 0 3 3 4 3 5 4 5 0 3 0 4 4 5 0 0 12 0 0 4 0 4 4 
4 12 5 5 4 4 4 4 4 4 4 4 4 0 5 5 4 4 5 4 5 4 5 5 4 4 6 4 5 2 4 4 
4 2 3 0 12 12 2 2 12 12 12 12 0 12 5 4 4 4 5 4 4 4 4 4 4 4 8 2 12 12 5 4 
4 4 4 4 4 4 4 4 5 4 4 4 5 4 5 4 4 4 4 5 4 4 5 4 4 4 4 5 5 4 5 5 
5 4 4 4 5 4 4 4 4 5 5 5 4 5 4 4 5 5 4 4 4 5 4 4 4 5 4 5 4 4 4 4 
