5 4 4 5 4 5 4 4 4 4 4 4 4 4 5 4 4 4 4 4 4 4 4 4 4 4 5 4 4 5 4 4 
4 5 5 4 4 0 2 0 3 1 0 0 0 0 4 4 5 4 4 0 0 2 0 0 0 0 0 0 0 0 4 5 
4 5 4 4 4 3 5 4 4 4 4 4 4 0 4 5 4 4 4 0 5 2 4 4 5 4 4 4 4 0 4 4 
5 4 5 4 4 0 4 4 4 4 4 4 4 0 4 0 0 3 0 1 4 0 0 0 0 0 0 2 4 0 4 4 
5 5 4 4 4 0 4 4 4 4 4 4 4 0 5 0 4 4 5 4 4 4 4 4 4 4 5 1 4 0 4 4 
4 4 4 4 4 1 4 4 4 4 4 4 4 0 0 3 4 3 2 1 1 0 0 2 6 0 0 0 4 0 4 4 
4 4 4 4 4 6 5 4 4 5 4 4 4 0 4 4 4 2 1 0 0 0 0 0 4 3 5 4 5 0 4 4 
4 4 4 4 4 3 0 0 2 0 0 0 4 1 0 0 4 0 0 0 0 0 3 0 4 0 3 2 4 0 4 4 
5 5 4 4 4 0 1 3 2 0 0 0 5 4 4 0 5 4 4 4 5 4 7 4 4 5 5 0 4 0 5 4 
4 5 4 4 4 0 0 2 0 0 1 3 4 4 5 0 4 4 5 0 0 0 1 3 0 0 1 0 5 1 4 4 
4 4 4 0 6 2 0 3 2 2 0 0 7 0 4 0 5 4 4 0 5 4 4 5 4 4 4 4 4 0 4 5 
4 0 0 0 4 0 0 1 0 0 3 0 4 0 0 1 4 4 4 0 5 2 0 0 2 0 3 2 4 0 5 4 
4 0 4 4 5 0 0 0 1 2 1 2 4 4 4 4 5 5 4 2 4 6 4 4 5 4 4 0 4 2 4 4 
4 0 5 4 4 0 0 0 0 1 0 3 5 5 4 4 4 4 4 0 4 2 0 0 3 0 4 2 4 0 4 4 
4 0 5 4 4 4 4 6 5 5 4 4 5 5 4 4 4 4 5 2 4 1 0 0 0 0 4 0 4 0 4 4 
4 0 4 0 0 0 4 3 0 0 5 4 4 5 4 5 4 4 4 1 4 2 1 0 0 3 4 0 4 0 4 4 
4 0 4 3 4 0 4 0 4 0 5 4 4 4 4 4 5 4 4 0 4 0 0 0 3 3 4 0 4 1 4 5 
4 0 4 0 4 0 4 0 4 0 4 0 0 0 0 0 0 0 4 1 4 0 0 0 0 0 4 1 0 0 5 4 
5 0 4 0 4 0 4 0 4 2 4 0 0 0 1 0 0 0 5 0 6 0 0 0 0 2 4 0 4 4 4 4 
4 0 4 1 5 0 0 3 4 0 4 3 2 3 1 2 0 1 4 0 4 0 0 0 3 0 5 0 4 4 5 4 
4 3 4 0 4 5 6 4 5 0 4 1 3 0 0 0 3 0 4 0 4 6 4 4 4 5 4 0 5 4 5 4 
4 0 4 0 4 0 0 2 7 1 4 1 1 0 0 1 0 3 6 0 0 0 4 4 4 4 4 0 0 0 4 4 
4 0 5 3 4 0 0 2 4 1 6 0 2 0 0 0 0 0 4 2 4 3 4 4 4 5 5 6 4 0 4 4 
5 0 0 0 5 2 0 0 4 3 4 0 0 0 2 0 0 0 7 0 4 0 4 2 0 0 0 0 4 2 4 5 
5 4 4 5 4 4 4 5 4 0 5 4 4 7 4 4 4 4 4 4 4 0 4 0 2 0 0 2 4 2 4 4 
4 4 4 0 3 0 2 0 5 0 0 1 5 0 0 0 2 0 5 0 0 0 4 0 3 1 2 0 4 0 4 4 
4 5 4 0 4 4 4 0 4 4 4 0 4 2 5 5 4 0 4 2 4 4 4 0 0 2 3 0 6 0 4 4 
5 3 0 1 4 5 4 0 0 0 0 0 4 0 5 4 4 0 0 0 4 4 4 0 0 0 0 0 4 0 4 4 
4 0 4 5 4 4 4 4 4 4 4 4 4 0 4 4 4 4 4 4 4 4 5 4 4 4 7 4 4 0 4 4 
4 0 0 0 0 0 0 0 0 0 0 0 0 3 4 4 5 4 4 4 5 4 4 4 4 4 2 0 3 0 4 4 
4 4 4 4 4 4 5 4 4 4 4 4 4 4 4 4 4 5 4 4 4 4 4 4 4 4 4 5 4 5 5 4 
5 4 4 4 4 4 4 4 4 4 4 5 4 4 4 4 4 4 4 4 5 4 4 4 4 4 4 4 4 5 5 4 
